WWWWWWWWWW
WWWWWWWWFWW
WWWWWWWWFFWW
WFWWWWFWFFFWW
WWFFFFWWWWWWWW
WWFFFFWW
WWFLFFWW
WWFFFFWW
WWFFFFWW
WFWWWWFW
WWWWWWWW
WWWWWWWW